4 4 4 4 7 4 4 4 4 4 4 4 4 4 4 4 4 4 4 4 4 4 4 4 4 4 4 4 4 4 4 4 4 4 4 4 4 4 4 4 4 4 4 4 4 4 4 4 4 4
4 0 0 0 7 6 0 0 0 0 2 3 0 6 0 0 0 0 0 0 0 0 0 0 0 0 0 0 0 0 0 0 0 0 0 0 0 0 0 0 7 6 6 0 0 0 0 0 0 4
4 0 0 0 7 6 0 0 0 0 2 3 0 6 0 0 0 0 0 0 0 0 0 0 0 0 0 0 0 0 0 0 0 0 0 0 0 0 0 0 7 6 6 0 0 0 0 0 0 4
4 0 0 0 7 6 0 0 0 0 2 3 0 6 0 6 0 0 0 0 0 0 0 0 0 0 0 0 0 0 0 0 0 0 0 0 0 0 0 0 7 6 6 0 0 0 0 0 0 4
4 0 0 0 7 6 0 0 0 0 2 3 0 6 0 0 0 0 0 0 0 0 0 0 0 0 0 0 0 0 0 0 0 0 0 0 0 0 0 0 7 6 6 0 0 0 0 0 0 4
4 0 0 0 7 6 0 0 0 0 2 3 0 6 0 0 0 0 0 0 0 0 0 0 0 0 0 0 0 0 0 0 0 0 0 0 0 0 0 0 7 6 6 0 0 0 0 0 0 4
4 0 0 0 7 6 0 0 0 0 2 3 0 6 0 0 0 0 0 0 0 0 0 0 0 0 0 0 0 0 0 0 0 0 0 0 0 0 0 0 7 6 6 0 0 0 0 0 0 4
4 0 0 0 7 6 0 0 0 0 2 3 0 6 0 0 0 0 0 0 0 0 0 0 0 0 0 0 0 0 0 0 0 0 0 0 0 0 0 0 7 6 6 0 0 0 0 0 0 4
4 0 0 0 7 6 0 0 0 0 2 3 0 6 0 0 0 0 0 0 0 0 0 0 0 0 0 0 0 0 0 0 0 0 0 0 0 0 0 0 7 6 6 0 0 0 0 0 0 4
4 0 0 0 7 6 0 0 0 0 2 3 0 6 0 0 0 0 0 0 0 0 0 0 0 0 0 0 0 0 0 0 0 0 0 0 0 0 0 0 7 6 6 0 0 0 0 0 0 4
4 0 0 0 7 6 0 0 0 0 2 3 0 6 0 0 0 0 0 0 0 0 0 0 0 0 0 0 0 0 0 0 0 0 0 0 0 0 0 0 7 6 6 0 0 0 0 0 0 4
4 0 0 0 7 6 0 0 0 0 2 3 0 6 0 0 0 0 0 0 0 0 0 0 0 0 0 0 0 0 0 0 0 0 0 0 0 0 0 0 7 6 6 0 0 0 0 0 0 4
4 0 0 0 7 6 0 0 0 0 2 3 0 6 0 0 0 0 0 0 0 0 0 0 0 0 0 0 0 0 0 0 0 0 0 0 0 0 0 0 7 6 6 0 0 0 0 0 0 4
4 0 0 0 7 6 3 3 3 3 3 3 3 3 3 3 0 0 0 0 0 0 0 0 0 0 0 0 0 0 0 0 0 0 0 0 0 0 0 0 7 6 6 0 0 0 0 0 0 4
4 0 0 0 7 6 3 0 0 0 2 3 0 0 0 0 0 0 0 0 0 0 0 0 0 0 0 0 0 0 0 0 0 0 0 0 0 0 0 0 7 6 6 0 0 0 0 0 0 4
4 0 0 0 7 6 3 0 0 0 2 3 0 0 0 0 0 0 0 0 0 0 0 0 0 0 0 0 0 0 0 0 0 0 0 0 0 0 0 0 7 6 6 0 0 0 0 0 0 4
4 0 0 0 7 6 3 0 0 0 2 3 0 0 0 0 0 0 0 0 0 0 0 0 0 0 0 0 0 0 0 0 0 0 0 0 0 0 0 0 7 6 6 0 0 0 0 0 0 4
4 0 0 0 7 6 3 0 0 0 2 3 0 0 0 0 0 0 0 0 0 0 0 0 0 0 0 0 0 0 0 0 0 0 0 0 0 0 0 0 7 6 6 0 0 0 0 0 0 4
4 0 0 0 7 6 3 0 0 0 2 3 0 0 0 0 0 0 0 0 0 0 0 0 0 0 0 0 0 0 0 0 0 0 0 0 0 0 0 0 7 6 6 0 0 0 0 0 0 4
4 0 0 0 7 6 3 0 0 0 2 3 0 0 0 0 0 0 0 3 3 3 3 3 3 3 3 0 0 0 0 0 0 1 0 0 0 0 0 0 7 6 6 0 0 0 0 0 0 4
4 0 0 0 7 6 3 3 3 3 2 3 0 0 0 0 0 0 0 3 2 2 2 2 2 2 2 0 0 0 0 0 0 0 0 0 0 0 0 0 7 6 6 0 0 0 0 0 0 4
4 0 0 0 7 6 0 0 0 0 2 3 0 0 0 0 0 0 0 3 2 2 2 2 2 2 3 0 0 0 0 0 0 0 0 0 0 0 0 0 6 6 6 0 0 0 0 0 0 4
4 0 0 0 7 6 0 0 0 0 2 3 0 0 0 1 0 0 0 3 2 2 2 2 2 2 3 0 0 0 0 0 0 0 0 0 0 0 0 0 0 0 0 0 0 0 0 0 0 4
4 0 0 0 7 6 0 0 0 0 2 3 0 0 0 0 0 0 0 3 2 2 2 2 2 2 3 0 0 0 0 0 0 0 0 0 0 0 0 0 7 6 6 0 0 0 0 0 0 4
4 0 0 0 7 6 0 0 0 0 2 3 0 0 0 0 0 0 0 3 2 2 2 2 2 2 3 0 0 0 0 0 0 0 0 0 0 0 0 0 7 6 6 0 0 0 0 0 0 4
4 0 0 0 7 6 0 0 0 0 2 3 0 0 0 0 0 0 0 3 2 2 2 2 2 2 3 0 0 0 0 0 0 0 0 0 0 0 0 0 7 6 6 0 0 0 0 0 0 4
4 0 0 0 7 6 0 0 0 0 2 3 0 0 0 0 0 0 0 3 2 2 2 2 2 2 3 0 0 0 0 0 0 0 0 0 0 0 0 6 7 6 0 0 0 0 0 0 0 4
4 0 0 0 7 6 0 0 0 0 2 3 0 0 0 0 0 0 0 3 2 2 2 2 2 2 3 0 0 0 0 0 0 0 0 0 0 0 0 0 7 6 6 0 0 0 0 0 0 4
4 0 0 0 7 6 0 0 0 0 2 3 0 0 0 0 0 0 0 3 2 2 2 2 2 2 3 0 0 0 0 0 0 0 0 0 0 0 0 0 7 6 6 0 0 0 0 0 0 4
4 0 0 0 7 6 0 0 0 0 2 3 0 0 0 0 0 0 0 3 2 2 2 2 2 2 3 0 0 0 0 0 0 0 0 0 0 0 0 0 7 6 6 0 0 0 0 0 0 4
4 0 0 0 7 6 0 0 0 0 2 2 0 0 2 0 0 0 0 3 2 2 2 2 2 2 3 0 0 0 0 0 0 0 0 0 0 0 0 0 7 6 6 0 0 0 0 0 0 4
4 0 0 0 7 6 0 0 0 0 2 3 0 0 0 11 13 1 3 3 2 2 2 2 2 2 3 0 0 0 0 0 0 0 0 0 0 0 0 0 0 0 0 7 6 6 0 0 0 0 0 0 4
4 0 0 0 7 6 0 0 0 0 2 3 0 1 0 7 6 6 6 3 2 2 2 2 2 2 3 0 0 0 0 0 0 0 0 0 0 0 0 0 7 6 6 0 0 0 0 0 0 4
4 0 0 0 7 6 0 0 0 0 2 3 0 0 0 7 6 6 6 3 2 2 2 2 2 2 3 0 0 0 0 0 0 0 0 0 0 0 0 0 7 6 6 0 0 0 0 0 0 4
4 0 0 0 7 6 0 0 0 0 2 3 0 0 0 7 6 6 6 3 2 2 2 2 2 2 3 0 0 0 0 0 0 0 0 0 0 0 0 0 7 6 6 0 0 0 0 0 0 4
4 0 0 0 7 6 0 0 0 0 2 3 0 0 0 7 6 6 6 3 2 2 2 2 2 2 3 0 0 0 0 0 0 0 0 0 0 0 0 0 7 6 6 0 0 0 0 0 0 4
4 0 0 0 7 6 0 0 0 0 2 3 0 0 0 7 6 6 6 3 3 3 3 3 3 3 3 0 0 0 0 0 0 0 0 0 0 0 0 0 7 6 6 0 0 0 0 0 0 4
4 0 0 0 7 6 0 0 0 0 2 3 0 0 0 8 14 14 14 14 12 2 3 6 0 0 0 0 0 0 0 0 0 0 0 0 0 0 0 0 7 6 6 0 0 0 0 0 0 4
4 0 0 0 7 6 0 0 0 0 2 3 1 0 1 0 0 0 0 0 0 2 3 0 0 0 0 0 0 0 0 0 0 0 0 0 0 0 0 0 7 6 6 0 0 0 0 0 0 4
4 0 0 0 7 6 0 0 0 0 2 3 0 0 0 0 0 0 0 0 0 2 3 0 0 0 0 0 0 0 0 0 0 0 0 0 0 0 0 0 7 6 6 0 0 0 0 0 0 4
4 0 0 0 7 6 0 0 0 0 2 3 0 0 1 0 0 0 0 0 0 2 3 0 0 0 0 0 0 0 0 0 0 0 0 0 0 0 0 0 7 6 6 0 0 0 0 0 0 4
4 0 0 0 7 6 0 0 0 0 2 3 0 0 0 0 0 0 0 0 0 2 3 0 0 0 0 0 0 0 0 0 0 0 0 0 0 0 0 0 7 6 6 0 0 0 0 0 0 4
4 0 0 0 7 6 0 0 0 0 2 3 0 0 0 0 0 0 0 0 0 2 3 0 0 0 0 0 0 0 0 0 0 0 0 0 0 0 0 0 7 6 6 0 0 0 0 0 0 4
4 0 0 0 7 6 0 0 0 0 2 3 0 0 0 0 0 0 0 0 0 2 3 0 0 0 0 0 0 0 0 0 0 0 0 0 0 0 0 0 7 6 6 0 0 0 0 0 0 4
4 0 0 0 7 6 0 0 0 0 2 3 0 0 0 0 1 0 0 0 0 2 3 0 0 0 0 0 0 0 0 0 0 0 0 0 0 0 0 0 7 6 6 0 0 0 0 0 0 4
4 0 0 0 7 6 0 0 0 0 2 3 0 0 0 0 0 0 0 0 0 2 3 0 0 0 0 0 0 0 0 0 0 0 0 0 0 0 0 0 7 6 6 0 0 0 0 0 0 4
4 0 0 0 7 6 0 0 0 0 2 3 0 0 0 0 0 0 0 0 0 2 3 0 0 0 0 0 0 0 0 0 0 0 0 0 0 0 0 0 7 6 6 0 0 0 0 0 0 4
4 0 0 0 7 6 0 0 0 0 2 3 0 0 0 0 0 0 0 0 0 2 3 0 0 0 0 0 0 0 0 0 0 0 0 0 0 0 0 0 7 6 6 0 0 0 0 0 0 4
4 0 0 0 7 6 0 0 0 0 2 3 0 0 0 0 0 0 0 0 0 2 3 0 0 0 0 0 0 0 0 0 0 0 0 0 0 0 0 0 7 6 6 0 0 0 0 0 0 4
4 4 4 4 7 4 4 4 4 4 4 4 4 4 4 4 4 4 4 4 4 4 4 4 4 4 4 4 4 4 4 4 4 4 4 4 4 4 4 4 4 4 4 4 4 4 4 4 4 4